Frame,Timestamp,Detection_ID,X1,Y1,X2,Y2,Width,Height,Center_X,Center_Y,Confidence,Class,Area
1,0.100,0,253,219,282,308,29,89,267.5,263.5,0.832,unknown,2581
1,0.100,1,641,240,684,322,43,82,662.5,281.0,0.821,unknown,3526
1,0.100,2,499,157,529,233,30,76,514.0,195.0,0.743,unknown,2280
6,0.600,0,591,241,645,324,54,83,618.0,282.5,0.883,unknown,4482
6,0.600,1,282,212,321,302,39,90,301.5,257.0,0.826,unknown,3510
6,0.600,2,486,161,515,240,29,79,500.5,200.5,0.773,unknown,2291
11,1.100,0,315,207,355,293,40,86,335.0,250.0,0.842,unknown,3440
11,1.100,1,464,168,502,246,38,78,483.0,207.0,0.764,unknown,2964
11,1.100,2,549,236,584,324,35,88,566.5,280.0,0.757,unknown,3080
11,1.100,3,746,303,767,408,21,105,756.5,355.5,0.711,unknown,2205
16,1.600,0,719,287,761,395,42,108,740.0,341.0,0.871,unknown,4536
16,1.600,1,339,199,376,286,37,87,357.5,242.5,0.837,unknown,3219
16,1.600,2,499,235,525,322,26,87,512.0,278.5,0.796,unknown,2262
16,1.600,3,440,171,477,249,37,78,458.5,210.0,0.778,unknown,2886
21,2.100,0,686,271,722,377,36,106,704.0,324.0,0.849,unknown,3816
21,2.100,1,726,270,757,369,31,99,741.5,319.5,0.814,unknown,3069
21,2.100,2,438,231,480,316,42,85,459.0,273.5,0.795,unknown,3570
21,2.100,3,363,192,396,276,33,84,379.5,234.0,0.761,unknown,2772
26,2.600,0,691,257,730,357,39,100,710.5,307.0,0.850,unknown,3900
26,2.600,1,661,259,692,362,31,103,676.5,310.5,0.769,unknown,3193
26,2.600,2,372,187,398,271,26,84,385.0,229.0,0.737,unknown,2184
31,3.100,0,628,252,665,353,37,101,646.5,302.5,0.855,unknown,3737
31,3.100,1,666,249,697,344,31,95,681.5,296.5,0.807,unknown,2945
31,3.100,2,378,179,408,265,30,86,393.0,222.0,0.804,unknown,2580
36,3.600,0,603,241,640,341,37,100,621.5,291.0,0.860,unknown,3700
36,3.600,1,635,242,668,336,33,94,651.5,289.0,0.817,unknown,3102
36,3.600,2,378,179,398,259,20,80,388.0,219.0,0.658,unknown,1600
36,3.600,3,391,182,415,265,24,83,403.0,223.5,0.503,unknown,1992
41,4.100,0,567,235,604,331,37,96,585.5,283.0,0.814,unknown,3552
41,4.100,1,736,283,767,394,31,111,751.5,338.5,0.808,unknown,3441
41,4.100,2,601,233,635,325,34,92,618.0,279.0,0.780,unknown,3128
41,4.100,3,376,178,401,256,25,78,388.5,217.0,0.715,unknown,1950
41,4.100,4,395,184,419,261,24,77,407.0,222.5,0.670,unknown,1848
41,4.100,5,438,187,459,267,21,80,448.5,227.0,0.660,unknown,1680
46,4.600,0,575,224,614,314,39,90,594.5,269.0,0.842,unknown,3510
46,4.600,1,706,270,748,387,42,117,727.0,328.5,0.834,unknown,4914
46,4.600,2,442,182,473,257,31,75,457.5,219.5,0.815,unknown,2325
46,4.600,3,536,227,577,319,41,92,556.5,273.0,0.815,unknown,3772
46,4.600,4,378,177,405,256,27,79,391.5,216.5,0.812,unknown,2133
51,5.100,0,668,257,714,371,46,114,691.0,314.0,0.847,unknown,5244
51,5.100,1,554,215,586,301,32,86,570.0,258.0,0.827,unknown,2752
51,5.100,2,504,216,540,307,36,91,522.0,261.5,0.805,unknown,3276
51,5.100,3,372,179,401,258,29,79,386.5,218.5,0.778,unknown,2291
51,5.100,4,430,174,458,246,28,72,444.0,210.0,0.670,unknown,2016
56,5.600,0,639,246,681,359,42,113,660.0,302.5,0.854,unknown,4746
56,5.600,1,484,209,522,299,38,90,503.0,254.0,0.844,unknown,3420
56,5.600,2,529,207,560,294,31,87,544.5,250.5,0.818,unknown,2697
56,5.600,3,375,179,398,256,23,77,386.5,217.5,0.746,unknown,1771
61,6.100,0,466,201,500,290,34,89,483.0,245.5,0.854,unknown,3026
61,6.100,1,615,232,651,341,36,109,633.0,286.5,0.840,unknown,3924
61,6.100,2,503,201,532,283,29,82,517.5,242.0,0.794,unknown,2378
61,6.100,3,365,169,383,236,18,67,374.0,202.5,0.661,unknown,1206
61,6.100,4,378,180,397,260,19,80,387.5,220.0,0.617,unknown,1520
66,6.600,0,602,221,634,327,32,106,618.0,274.0,0.860,unknown,3392
66,6.600,1,454,196,488,280,34,84,471.0,238.0,0.826,unknown,2856
66,6.600,2,492,195,518,274,26,79,505.0,234.5,0.817,unknown,2054
66,6.600,3,370,180,400,259,30,79,385.0,219.5,0.739,unknown,2370
66,6.600,4,327,168,352,237,25,69,339.5,202.5,0.704,unknown,1725
71,7.100,0,586,208,621,309,35,101,603.5,258.5,0.874,unknown,3535
71,7.100,1,444,189,475,276,31,87,459.5,232.5,0.792,unknown,2697
71,7.100,2,368,179,400,259,32,80,384.0,219.0,0.775,unknown,2560
71,7.100,3,478,188,507,270,29,82,492.5,229.0,0.775,unknown,2378
71,7.100,4,290,170,327,235,37,65,308.5,202.5,0.758,unknown,2405
76,7.600,0,576,197,607,295,31,98,591.5,246.0,0.831,unknown,3038
76,7.600,1,263,169,290,236,27,67,276.5,202.5,0.808,unknown,1809
76,7.600,2,440,181,470,262,30,81,455.0,221.5,0.801,unknown,2430
76,7.600,3,478,181,506,258,28,77,492.0,219.5,0.781,unknown,2156
76,7.600,4,369,179,400,259,31,80,384.5,219.0,0.743,unknown,2480
81,8.100,0,567,187,600,283,33,96,583.5,235.0,0.845,unknown,3168
81,8.100,1,441,171,474,254,33,83,457.5,212.5,0.810,unknown,2739
81,8.100,2,259,173,286,243,27,70,272.5,208.0,0.806,unknown,1890
81,8.100,3,474,174,502,251,28,77,488.0,212.5,0.800,unknown,2156
81,8.100,4,371,179,397,259,26,80,384.0,219.0,0.706,unknown,2080
81,8.100,5,273,53,287,85,14,32,280.0,69.0,0.528,unknown,448
86,8.600,0,564,178,595,272,31,94,579.5,225.0,0.845,unknown,2914
86,8.600,1,483,167,511,241,28,74,497.0,204.0,0.827,unknown,2072
86,8.600,2,450,166,479,240,29,74,464.5,203.0,0.819,unknown,2146
86,8.600,3,375,177,403,259,28,82,389.0,218.0,0.808,unknown,2296
86,8.600,4,272,180,300,250,28,70,286.0,215.0,0.633,unknown,1960
86,8.600,5,375,178,416,261,41,83,395.5,219.5,0.504,unknown,3403
91,9.100,0,570,172,598,261,28,89,584.0,216.5,0.809,unknown,2492
91,9.100,1,291,186,317,261,26,75,304.0,223.5,0.802,unknown,1950
91,9.100,2,460,158,489,233,29,75,474.5,195.5,0.790,unknown,2175
91,9.100,3,489,162,518,232,29,70,503.5,197.0,0.767,unknown,2030
91,9.100,4,372,178,406,258,34,80,389.0,218.0,0.754,unknown,2720
91,9.100,5,249,57,264,89,15,32,256.5,73.0,0.600,unknown,480
96,9.600,0,577,163,607,249,30,86,592.0,206.0,0.807,unknown,2580
96,9.600,1,503,158,527,228,24,70,515.0,193.0,0.779,unknown,1680
96,9.600,2,378,177,413,258,35,81,395.5,217.5,0.765,unknown,2835
96,9.600,3,476,154,505,226,29,72,490.5,190.0,0.744,unknown,2088
96,9.600,4,315,191,342,266,27,75,328.5,228.5,0.732,unknown,2025
96,9.600,5,236,59,249,92,13,33,242.5,75.5,0.533,unknown,429
101,10.100,0,491,148,520,218,29,70,505.5,183.0,0.856,unknown,2030
101,10.100,1,590,154,617,233,27,79,603.5,193.5,0.795,unknown,2133
101,10.100,2,375,178,409,256,34,78,392.0,217.0,0.777,unknown,2652
101,10.100,3,348,198,381,275,33,77,364.5,236.5,0.772,unknown,2541
101,10.100,4,516,151,541,218,25,67,528.5,184.5,0.738,unknown,1675
101,10.100,5,222,60,235,94,13,34,228.5,77.0,0.591,unknown,442
106,10.600,0,535,146,559,213,24,67,547.0,179.5,0.824,unknown,1608
106,10.600,1,607,144,629,224,22,80,618.0,184.0,0.777,unknown,1760
106,10.600,2,509,143,535,211,26,68,522.0,177.0,0.699,unknown,1768
106,10.600,3,380,179,415,280,35,101,397.5,229.5,0.619,unknown,3535
106,10.600,4,389,197,415,280,26,83,402.0,238.5,0.562,unknown,2158
111,11.100,0,616,140,646,217,30,77,631.0,178.5,0.795,unknown,2310
111,11.100,1,372,178,403,252,31,74,387.5,215.0,0.770,unknown,2294
111,11.100,2,548,144,572,206,24,62,560.0,175.0,0.762,unknown,1488
111,11.100,3,525,139,552,206,27,67,538.5,172.5,0.717,unknown,1809
111,11.100,4,194,64,210,99,16,35,202.0,81.5,0.582,unknown,560
116,11.600,0,464,209,502,286,38,77,483.0,247.5,0.774,unknown,2926
116,11.600,1,369,180,400,258,31,78,384.5,219.0,0.739,unknown,2418
116,11.600,2,734,226,767,311,33,85,750.5,268.5,0.726,unknown,2805
116,11.600,3,566,139,589,204,23,65,577.5,171.5,0.724,unknown,1495
116,11.600,4,633,135,659,210,26,75,646.0,172.5,0.711,unknown,1950
116,11.600,5,541,133,569,202,28,69,555.0,167.5,0.654,unknown,1932
116,11.600,6,181,67,197,104,16,37,189.0,85.5,0.622,unknown,592
121,12.100,0,649,129,676,203,27,74,662.5,166.0,0.788,unknown,1998
121,12.100,1,509,214,538,295,29,81,523.5,254.5,0.750,unknown,2349
121,12.100,2,561,128,585,193,24,65,573.0,160.5,0.746,unknown,1560
121,12.100,3,374,181,402,261,28,80,388.0,221.0,0.740,unknown,2240
121,12.100,4,585,133,610,198,25,65,597.5,165.5,0.734,unknown,1625
121,12.100,5,166,70,180,107,14,37,173.0,88.5,0.604,unknown,518
126,12.600,0,636,211,681,296,45,85,658.5,253.5,0.836,unknown,3825
126,12.600,1,552,215,578,299,26,84,565.0,257.0,0.798,unknown,2184
126,12.600,2,600,128,621,192,21,64,610.5,160.0,0.772,unknown,1344
126,12.600,3,382,181,404,260,22,79,393.0,220.5,0.771,unknown,1738
126,12.600,4,663,126,688,196,25,70,675.5,161.0,0.759,unknown,1750
126,12.600,5,150,74,169,108,19,34,159.5,91.0,0.647,unknown,646
126,12.600,6,576,127,599,187,23,60,587.5,157.0,0.640,unknown,1380
131,13.100,0,380,184,407,263,27,79,393.5,223.5,0.813,unknown,2133
131,13.100,1,591,224,638,306,47,82,614.5,265.0,0.807,unknown,3854
131,13.100,2,683,119,703,188,20,69,693.0,153.5,0.722,unknown,1380
131,13.100,3,615,125,639,185,24,60,627.0,155.0,0.706,unknown,1440
131,13.100,4,589,120,615,182,26,62,602.0,151.0,0.694,unknown,1612
131,13.100,5,135,77,148,112,13,35,141.5,94.5,0.650,unknown,455
136,13.600,0,626,227,673,309,47,82,649.5,268.0,0.850,unknown,3854
136,13.600,1,713,252,766,346,53,94,739.5,299.0,0.839,unknown,4982
136,13.600,2,563,196,600,278,37,82,581.5,237.0,0.811,unknown,3034
136,13.600,3,693,117,716,186,23,69,704.5,151.5,0.742,unknown,1587
136,13.600,4,624,122,646,183,22,61,635.0,152.5,0.736,unknown,1342
136,13.600,5,380,185,404,264,24,79,392.0,224.5,0.715,unknown,1896
136,13.600,6,121,79,136,118,15,39,128.5,98.5,0.705,unknown,585
136,13.600,7,600,116,624,178,24,62,612.0,147.0,0.697,unknown,1488
141,14.100,0,513,189,555,270,42,81,534.0,229.5,0.828,unknown,3402
141,14.100,1,705,112,726,180,21,68,715.5,146.0,0.745,unknown,1428
141,14.100,2,385,184,411,265,26,81,398.0,224.5,0.732,unknown,2106
141,14.100,3,616,113,637,175,21,62,626.5,144.0,0.669,unknown,1302
141,14.100,4,677,228,711,335,34,107,694.0,281.5,0.639,unknown,3638
141,14.100,5,636,118,660,176,24,58,648.0,147.0,0.634,unknown,1392
141,14.100,6,105,83,120,120,15,37,112.5,101.5,0.631,unknown,555
146,14.600,0,630,235,666,328,36,93,648.0,281.5,0.801,unknown,3348
146,14.600,1,385,187,409,271,24,84,397.0,229.0,0.769,unknown,2016
146,14.600,2,483,186,521,262,38,76,502.0,224.0,0.767,unknown,2888
146,14.600,3,627,110,648,170,21,60,637.5,140.0,0.707,unknown,1260
146,14.600,4,709,110,731,178,22,68,720.0,144.0,0.696,unknown,1496
146,14.600,5,727,229,755,312,28,83,741.0,270.5,0.678,unknown,2324
146,14.600,6,90,86,105,124,15,38,97.5,105.0,0.635,unknown,570
146,14.600,7,643,113,666,172,23,59,654.5,142.5,0.602,unknown,1357
151,15.100,0,388,196,417,280,29,84,402.5,238.0,0.746,unknown,2436
151,15.100,1,589,228,624,316,35,88,606.5,272.0,0.740,unknown,3080
151,15.100,2,711,111,727,176,16,65,719.0,143.5,0.693,unknown,1040
151,15.100,3,70,90,89,128,19,38,79.5,109.0,0.620,unknown,722
151,15.100,4,658,112,679,167,21,55,668.5,139.5,0.599,unknown,1155
151,15.100,5,438,190,465,274,27,84,451.5,232.0,0.598,unknown,2268
151,15.100,6,636,109,658,165,22,56,647.0,137.0,0.561,unknown,1232
156,15.600,0,545,222,577,309,32,87,561.0,265.5,0.813,unknown,2784
156,15.600,1,449,198,479,284,30,86,464.0,241.0,0.748,unknown,2580
156,15.600,2,55,92,69,133,14,41,62.0,112.5,0.701,unknown,574
156,15.600,3,645,107,664,164,19,57,654.5,135.5,0.661,unknown,1083
156,15.600,4,695,114,715,176,20,62,705.0,145.0,0.619,unknown,1240
156,15.600,5,667,109,689,164,22,55,678.0,136.5,0.562,unknown,1210
156,15.600,6,394,182,419,248,25,66,406.5,215.0,0.511,unknown,1650
161,16.100,0,348,172,382,245,34,73,365.0,208.5,0.848,unknown,2482
161,16.100,1,474,202,507,286,33,84,490.5,244.0,0.784,unknown,2772
161,16.100,2,499,220,543,307,44,87,521.0,263.5,0.780,unknown,3828
161,16.100,3,431,205,464,294,33,89,447.5,249.5,0.672,unknown,2937
161,16.100,4,30,95,52,140,22,45,41.0,117.5,0.625,unknown,990
161,16.100,5,673,110,701,181,28,71,687.0,145.5,0.581,unknown,1988
161,16.100,6,655,103,677,160,22,57,666.0,131.5,0.578,unknown,1254
166,16.600,0,496,205,524,291,28,86,510.0,248.0,0.778,unknown,2408
166,16.600,1,314,171,352,241,38,70,333.0,206.0,0.770,unknown,2660
166,16.600,2,449,209,472,295,23,86,460.5,252.0,0.671,unknown,1978
166,16.600,3,466,218,492,307,26,89,479.0,262.5,0.609,unknown,2314
166,16.600,4,23,98,45,140,22,42,34.0,119.0,0.591,unknown,924
166,16.600,5,683,105,708,158,25,53,695.5,131.5,0.557,unknown,1325
166,16.600,6,653,116,676,186,23,70,664.5,151.0,0.503,unknown,1610
171,17.100,0,513,209,552,294,39,85,532.5,251.5,0.842,unknown,3315
171,17.100,1,280,166,313,237,33,71,296.5,201.5,0.710,unknown,2343
171,17.100,2,670,100,693,157,23,57,681.5,128.5,0.685,unknown,1311
171,17.100,3,634,121,658,191,24,70,646.0,156.0,0.651,unknown,1680
171,17.100,4,5,102,22,145,17,43,13.5,123.5,0.638,unknown,731
171,17.100,5,694,106,714,157,20,51,704.0,131.5,0.628,unknown,1020
171,17.100,6,453,209,490,301,37,92,471.5,255.0,0.602,unknown,3404
176,17.600,0,459,215,503,302,44,87,481.0,258.5,0.826,unknown,3828
176,17.600,1,554,213,582,302,28,89,568.0,257.5,0.766,unknown,2492
176,17.600,2,610,126,637,196,27,70,623.5,161.0,0.743,unknown,1890
176,17.600,3,239,164,274,234,35,70,256.5,199.0,0.727,unknown,2450
176,17.600,4,675,100,698,157,23,57,686.5,128.5,0.626,unknown,1311
176,17.600,5,397,211,430,300,33,89,413.5,255.5,0.604,unknown,2937
181,18.100,0,359,210,400,293,41,83,379.5,251.5,0.828,unknown,3403
181,18.100,1,585,217,623,306,38,89,604.0,261.5,0.779,unknown,3382
181,18.100,2,498,223,533,311,35,88,515.5,267.0,0.774,unknown,3080
181,18.100,3,587,130,617,201,30,71,602.0,165.5,0.711,unknown,2130
181,18.100,4,199,161,230,230,31,69,214.5,195.5,0.708,unknown,2139
181,18.100,5,704,105,720,156,16,51,712.0,130.5,0.638,unknown,816
181,18.100,6,678,100,697,156,19,56,687.5,128.0,0.630,unknown,1064
186,18.600,0,526,228,560,321,34,93,543.0,274.5,0.833,unknown,3162
186,18.600,1,623,223,657,315,34,92,640.0,269.0,0.828,unknown,3128
186,18.600,2,168,161,204,226,36,65,186.0,193.5,0.730,unknown,2340
186,18.600,3,323,209,352,289,29,80,337.5,249.0,0.697,unknown,2320
186,18.600,4,568,133,594,207,26,74,581.0,170.0,0.696,unknown,1924
186,18.600,5,681,99,698,155,17,56,689.5,127.0,0.656,unknown,952
186,18.600,6,707,103,723,155,16,52,715.0,129.0,0.649,unknown,832
191,19.100,0,648,228,691,324,43,96,669.5,276.0,0.850,unknown,4128
191,19.100,1,548,241,599,337,51,96,573.5,289.0,0.839,unknown,4896
191,19.100,2,139,157,166,222,27,65,152.5,189.5,0.796,unknown,1755
191,19.100,3,267,203,312,285,45,82,289.5,244.0,0.730,unknown,3690
191,19.100,4,541,136,567,210,26,74,554.0,173.0,0.701,unknown,1924
191,19.100,5,708,105,723,156,15,51,715.5,130.5,0.669,unknown,765
191,19.100,6,683,96,699,154,16,58,691.0,125.0,0.573,unknown,928
196,19.600,0,677,243,719,339,42,96,698.0,291.0,0.836,unknown,4032
196,19.600,1,584,253,625,351,41,98,604.5,302.0,0.824,unknown,4018
196,19.600,2,247,195,274,275,27,80,260.5,235.0,0.789,unknown,2160
196,19.600,3,515,141,537,215,22,74,526.0,178.0,0.783,unknown,1628
196,19.600,4,105,156,137,219,32,63,121.0,187.5,0.774,unknown,2016
196,19.600,5,707,104,723,156,16,52,715.0,130.0,0.696,unknown,832
196,19.600,6,681,96,701,153,20,57,691.0,124.5,0.675,unknown,1140
201,20.100,0,616,264,649,370,33,106,632.5,317.0,0.819,unknown,3498
201,20.100,1,704,254,743,353,39,99,723.5,303.5,0.782,unknown,3861
201,20.100,2,487,144,517,222,30,78,502.0,183.0,0.779,unknown,2340
201,20.100,3,218,188,250,266,32,78,234.0,227.0,0.753,unknown,2496
201,20.100,4,83,153,112,215,29,62,97.5,184.0,0.739,unknown,1798
201,20.100,5,677,97,697,154,20,57,687.0,125.5,0.717,unknown,1140
201,20.100,6,703,106,721,156,18,50,712.0,131.0,0.643,unknown,900
206,20.600,0,184,185,213,258,29,73,198.5,221.5,0.866,unknown,2117
206,20.600,1,639,283,693,395,54,112,666.0,339.0,0.836,unknown,6048
206,20.600,2,731,263,767,366,36,103,749.0,314.5,0.809,unknown,3708
206,20.600,3,452,150,489,228,37,78,470.5,189.0,0.774,unknown,2886
206,20.600,4,53,150,83,211,30,61,68.0,180.5,0.772,unknown,1830
206,20.600,5,696,109,713,158,17,49,704.5,133.5,0.712,unknown,833
206,20.600,6,672,100,693,156,21,56,682.5,128.0,0.679,unknown,1176
211,21.100,0,652,294,704,409,52,115,678.0,351.5,0.858,unknown,5980
211,21.100,1,29,147,54,207,25,60,41.5,177.0,0.792,unknown,1500
211,21.100,2,663,100,685,157,22,57,674.0,128.5,0.740,unknown,1254
211,21.100,3,693,112,712,158,19,46,702.5,135.0,0.732,unknown,874
211,21.100,4,151,183,182,253,31,70,166.5,218.0,0.709,unknown,2170
216,21.600,0,632,297,668,412,36,115,650.0,354.5,0.835,unknown,4140
216,21.600,1,125,182,160,253,35,71,142.5,217.5,0.826,unknown,2485
216,21.600,2,662,103,683,160,21,57,672.5,131.5,0.787,unknown,1197
216,21.600,3,7,147,32,204,25,57,19.5,175.5,0.774,unknown,1425
216,21.600,4,686,112,705,162,19,50,695.5,137.0,0.688,unknown,950
216,21.600,5,394,159,419,238,25,79,406.5,198.5,0.621,unknown,1975
221,22.100,0,583,295,623,410,40,115,603.0,352.5,0.875,unknown,4600
221,22.100,1,366,160,402,238,36,78,384.0,199.0,0.773,unknown,2808
221,22.100,2,741,236,767,322,26,86,754.0,279.0,0.759,unknown,2236
221,22.100,3,97,180,126,251,29,71,111.5,215.5,0.753,unknown,2059
221,22.100,4,658,106,680,163,22,57,669.0,134.5,0.742,unknown,1254
221,22.100,5,681,116,699,166,18,50,690.0,141.0,0.557,unknown,900
226,22.600,0,535,284,578,398,43,114,556.5,341.0,0.838,unknown,4902
226,22.600,1,62,180,94,249,32,69,78.0,214.5,0.759,unknown,2208
226,22.600,2,702,226,732,312,30,86,717.0,269.0,0.742,unknown,2580
226,22.600,3,675,118,695,168,20,50,685.0,143.0,0.725,unknown,1000
226,22.600,4,652,108,675,168,23,60,663.5,138.0,0.708,unknown,1380
226,22.600,5,327,159,352,238,25,79,339.5,198.5,0.702,unknown,1975
231,23.100,0,720,289,767,400,47,111,743.5,344.5,0.858,unknown,5217
231,23.100,1,499,272,544,386,45,114,521.5,329.0,0.826,unknown,5130
231,23.100,2,645,111,670,172,25,61,657.5,141.5,0.784,unknown,1525
231,23.100,3,670,214,705,299,35,85,687.5,256.5,0.781,unknown,2975
231,23.100,4,291,159,320,239,29,80,305.5,199.0,0.778,unknown,2320
231,23.100,5,46,179,74,244,28,65,60.0,211.5,0.748,unknown,1820
231,23.100,6,671,121,690,174,19,53,680.5,147.5,0.560,unknown,1007
236,23.600,0,462,259,508,364,46,105,485.0,311.5,0.862,unknown,4830
236,23.600,1,255,157,288,237,33,80,271.5,197.0,0.770,unknown,2640
236,23.600,2,37,174,62,243,25,69,49.5,208.5,0.769,unknown,1725
236,23.600,3,691,276,726,384,35,108,708.5,330.0,0.763,unknown,3780
236,23.600,4,643,113,666,174,23,61,654.5,143.5,0.757,unknown,1403
236,23.600,5,639,205,665,285,26,80,652.0,245.0,0.757,unknown,2080
236,23.600,6,667,122,688,175,21,53,677.5,148.5,0.653,unknown,1113
241,24.100,0,656,272,706,379,50,107,681.0,325.5,0.867,unknown,5350
241,24.100,1,450,248,482,352,32,104,466.0,300.0,0.846,unknown,3328
241,24.100,2,613,200,641,277,28,77,627.0,238.5,0.810,unknown,2156
241,24.100,3,37,174,62,243,25,69,49.5,208.5,0.774,unknown,1725
241,24.100,4,234,156,265,234,31,78,249.5,195.0,0.761,unknown,2418
241,24.100,5,641,114,666,177,25,63,653.5,145.5,0.755,unknown,1575
241,24.100,6,665,122,684,178,19,56,674.5,150.0,0.705,unknown,1064
246,24.600,0,632,260,664,363,32,103,648.0,311.5,0.805,unknown,3296
246,24.600,1,37,175,62,243,25,68,49.5,209.0,0.784,unknown,1700
246,24.600,2,570,192,606,268,36,76,588.0,230.0,0.756,unknown,2736
246,24.600,3,633,119,659,181,26,62,646.0,150.0,0.712,unknown,1612
246,24.600,4,213,153,242,229,29,76,227.5,191.0,0.706,unknown,2204
246,24.600,5,401,243,448,337,47,94,424.5,290.0,0.695,unknown,4418
246,24.600,6,664,124,687,182,23,58,675.5,153.0,0.688,unknown,1334
251,25.100,0,599,253,642,354,43,101,620.5,303.5,0.812,unknown,4343
251,25.100,1,371,229,420,326,49,97,395.5,277.5,0.811,unknown,4753
251,25.100,2,193,152,221,225,28,73,207.0,188.5,0.796,unknown,2044
251,25.100,3,37,175,62,243,25,68,49.5,209.0,0.765,unknown,1700
251,25.100,4,546,188,576,264,30,76,561.0,226.0,0.755,unknown,2280
251,25.100,5,634,121,658,184,24,63,646.0,152.5,0.695,unknown,1512
251,25.100,6,657,127,679,185,22,58,668.0,156.0,0.689,unknown,1276
256,25.600,0,348,220,393,316,45,96,370.5,268.0,0.886,unknown,4320
256,25.600,1,37,174,62,243,25,69,49.5,208.5,0.798,unknown,1725
256,25.600,2,630,123,653,187,23,64,641.5,155.0,0.783,unknown,1472
256,25.600,3,569,248,603,347,34,99,586.0,297.5,0.776,unknown,3366
256,25.600,4,517,183,549,257,32,74,533.0,220.0,0.756,unknown,2368
256,25.600,5,180,149,207,222,27,73,193.5,185.5,0.750,unknown,1971
256,25.600,6,649,132,670,191,21,59,659.5,161.5,0.621,unknown,1239
261,26.100,0,318,214,363,303,45,89,340.5,258.5,0.813,unknown,4005
261,26.100,1,37,174,62,243,25,69,49.5,208.5,0.788,unknown,1725
261,26.100,2,532,242,571,340,39,98,551.5,291.0,0.781,unknown,3822
261,26.100,3,161,147,188,218,27,71,174.5,182.5,0.758,unknown,1917
261,26.100,4,620,125,644,191,24,66,632.0,158.0,0.755,unknown,1584
261,26.100,5,485,177,510,248,25,71,497.5,212.5,0.711,unknown,1775
261,26.100,6,640,135,662,192,22,57,651.0,163.5,0.546,unknown,1254
266,26.600,0,307,206,339,293,32,87,323.0,249.5,0.815,unknown,2784
266,26.600,1,503,238,534,336,31,98,518.5,287.0,0.807,unknown,3038
266,26.600,2,35,174,61,244,26,70,48.0,209.0,0.805,unknown,1820
266,26.600,3,610,129,635,194,25,65,622.5,161.5,0.768,unknown,1625
266,26.600,4,454,173,482,245,28,72,468.0,209.0,0.755,unknown,2016
266,26.600,5,635,132,656,197,21,65,645.5,164.5,0.716,unknown,1365
266,26.600,6,147,144,169,214,22,70,158.0,179.0,0.701,unknown,1540
271,27.100,0,462,236,495,332,33,96,478.5,284.0,0.811,unknown,3168
271,27.100,1,285,193,314,281,29,88,299.5,237.0,0.810,unknown,2552
271,27.100,2,600,131,626,199,26,68,613.0,165.0,0.754,unknown,1768
271,27.100,3,32,175,54,243,22,68,43.0,209.0,0.732,unknown,1496
271,27.100,4,130,142,151,210,21,68,140.5,176.0,0.715,unknown,1428
271,27.100,5,633,137,656,202,23,65,644.5,169.5,0.694,unknown,1495
276,27.600,0,435,229,464,324,29,95,449.5,276.5,0.783,unknown,2755
276,27.600,1,266,186,302,271,36,85,284.0,228.5,0.775,unknown,3060
276,27.600,2,630,140,652,207,22,67,641.0,173.5,0.744,unknown,1474
276,27.600,3,19,175,48,243,29,68,33.5,209.0,0.733,unknown,1972
276,27.600,4,120,142,139,210,19,68,129.5,176.0,0.699,unknown,1292
276,27.600,5,599,135,624,203,25,68,611.5,169.0,0.671,unknown,1700
276,27.600,6,390,167,414,234,24,67,402.0,200.5,0.661,unknown,1608
281,28.100,0,116,145,140,215,24,70,128.0,180.0,0.795,unknown,1680
281,28.100,1,265,181,293,261,28,80,279.0,221.0,0.769,unknown,2240
281,28.100,2,598,138,624,207,26,69,611.0,172.5,0.760,unknown,1794
281,28.100,3,630,142,652,207,22,65,641.0,174.5,0.746,unknown,1430
281,28.100,4,358,165,388,230,30,65,373.0,197.5,0.732,unknown,1950
281,28.100,5,0,176,27,241,27,65,13.5,208.5,0.726,unknown,1755
281,28.100,6,407,244,434,320,27,76,420.5,282.0,0.634,unknown,2052
286,28.600,0,256,174,287,255,31,81,271.5,214.5,0.811,unknown,2511
286,28.600,1,379,222,412,312,33,90,395.5,267.0,0.805,unknown,2970
286,28.600,2,130,148,157,221,27,73,143.5,184.5,0.787,unknown,1971
286,28.600,3,596,142,623,212,27,70,609.5,177.0,0.776,unknown,1890
286,28.600,4,623,148,647,214,24,66,635.0,181.0,0.765,unknown,1584
286,28.600,5,328,160,352,228,24,68,340.0,194.0,0.714,unknown,1632
286,28.600,6,0,169,14,239,14,70,7.0,204.0,0.584,unknown,980
291,29.100,0,254,168,290,248,36,80,272.0,208.0,0.832,unknown,2880
291,29.100,1,354,217,386,310,32,93,370.0,263.5,0.829,unknown,2976
291,29.100,2,591,145,619,218,28,73,605.0,181.5,0.804,unknown,2044
291,29.100,3,619,151,642,220,23,69,630.5,185.5,0.756,unknown,1587
291,29.100,4,302,159,325,225,23,66,313.5,192.0,0.741,unknown,1518
291,29.100,5,145,152,172,224,27,72,158.5,188.0,0.739,unknown,1944
296,29.600,0,333,213,367,299,34,86,350.0,256.0,0.807,unknown,2924
296,29.600,1,583,152,614,225,31,73,598.5,188.5,0.782,unknown,2263
296,29.600,2,166,157,194,231,28,74,180.0,194.0,0.771,unknown,2072
296,29.600,3,615,157,638,225,23,68,626.5,191.0,0.737,unknown,1564
296,29.600,4,273,162,304,238,31,76,288.5,200.0,0.719,unknown,2356
301,30.100,0,581,159,611,234,30,75,596.0,196.5,0.828,unknown,2250
301,30.100,1,185,158,217,234,32,76,201.0,196.0,0.824,unknown,2432
301,30.100,2,313,209,344,296,31,87,328.5,252.5,0.788,unknown,2697
301,30.100,3,617,161,643,231,26,70,630.0,196.0,0.786,unknown,1820
301,30.100,4,297,158,323,229,26,71,310.0,193.5,0.776,unknown,1846
301,30.100,5,242,158,266,222,24,64,254.0,190.0,0.687,unknown,1536
306,30.600,0,618,167,642,241,24,74,630.0,204.0,0.833,unknown,1776
306,30.600,1,585,166,614,239,29,73,599.5,202.5,0.807,unknown,2117
306,30.600,2,329,153,354,225,25,72,341.5,189.0,0.801,unknown,1800
306,30.600,3,289,204,325,287,36,83,307.0,245.5,0.796,unknown,2988
306,30.600,4,222,161,243,238,21,77,232.5,199.5,0.611,unknown,1617
311,31.100,0,588,168,617,252,29,84,602.5,210.0,0.844,unknown,2436
311,31.100,1,355,151,390,221,35,70,372.5,186.0,0.809,unknown,2450
311,31.100,2,269,200,300,284,31,84,284.5,242.0,0.804,unknown,2604
311,31.100,3,246,161,273,240,27,79,259.5,200.5,0.780,unknown,2133
311,31.100,4,187,166,213,232,26,66,200.0,199.0,0.763,unknown,1716
311,31.100,5,619,172,642,247,23,75,630.5,209.5,0.732,unknown,1725
316,31.600,0,591,177,619,256,28,79,605.0,216.5,0.798,unknown,2212
316,31.600,1,185,169,210,236,25,67,197.5,202.5,0.780,unknown,1675
316,31.600,2,257,195,288,277,31,82,272.5,236.0,0.771,unknown,2542
316,31.600,3,278,165,304,243,26,78,291.0,204.0,0.742,unknown,2028
316,31.600,4,624,182,649,256,25,74,636.5,219.0,0.672,unknown,1850
316,31.600,5,400,148,425,218,25,70,412.5,183.0,0.554,unknown,1750
321,32.100,0,596,181,624,266,28,85,610.0,223.5,0.823,unknown,2380
321,32.100,1,302,167,335,251,33,84,318.5,209.0,0.806,unknown,2772
321,32.100,2,255,195,279,277,24,82,267.0,236.0,0.798,unknown,1968
321,32.100,3,203,174,225,241,22,67,214.0,207.5,0.763,unknown,1474
321,32.100,4,629,185,655,263,26,78,642.0,224.0,0.695,unknown,2028
326,32.600,0,455,147,484,216,29,69,469.5,181.5,0.802,unknown,2001
326,32.600,1,604,189,632,273,28,84,618.0,231.0,0.785,unknown,2352
326,32.600,2,265,200,299,279,34,79,282.0,239.5,0.780,unknown,2686
326,32.600,3,227,173,251,242,24,69,239.0,207.5,0.747,unknown,1656
326,32.600,4,636,192,661,274,25,82,648.5,233.0,0.739,unknown,2050
326,32.600,5,330,168,358,251,28,83,344.0,209.5,0.711,unknown,2324
331,33.100,0,360,176,396,256,36,80,378.0,216.0,0.859,unknown,2880
331,33.100,1,614,195,645,280,31,85,629.5,237.5,0.826,unknown,2635
331,33.100,2,477,148,509,220,32,72,493.0,184.0,0.782,unknown,2304
331,33.100,3,260,175,286,243,26,68,273.0,209.0,0.751,unknown,1768
331,33.100,4,290,200,323,283,33,83,306.5,241.5,0.731,unknown,2739
331,33.100,5,643,198,673,284,30,86,658.0,241.0,0.678,unknown,2580
336,33.600,0,313,208,349,291,36,83,331.0,249.5,0.854,unknown,2988
336,33.600,1,625,205,655,292,30,87,640.0,248.5,0.793,unknown,2610
336,33.600,2,287,178,315,245,28,67,301.0,211.5,0.764,unknown,1876
336,33.600,3,387,177,425,259,38,82,406.0,218.0,0.733,unknown,3116
336,33.600,4,658,206,685,290,27,84,671.5,248.0,0.722,unknown,2268
336,33.600,5,486,155,510,227,24,72,498.0,191.0,0.699,unknown,1728
341,34.100,0,335,212,366,300,31,88,350.5,256.0,0.815,unknown,2728
341,34.100,1,638,210,669,301,31,91,653.5,255.5,0.808,unknown,2821
341,34.100,2,474,160,504,237,30,77,489.0,198.5,0.775,unknown,2310
341,34.100,3,313,178,340,248,27,70,326.5,213.0,0.693,unknown,1890
341,34.100,4,668,210,697,296,29,86,682.5,253.0,0.680,unknown,2494
346,34.600,0,651,218,684,309,33,91,667.5,263.5,0.807,unknown,3003
346,34.600,1,360,219,393,306,33,87,376.5,262.5,0.796,unknown,2871
346,34.600,2,444,180,482,270,38,90,463.0,225.0,0.753,unknown,3420
346,34.600,3,683,217,709,307,26,90,696.0,262.0,0.744,unknown,2340
346,34.600,4,355,177,376,246,21,69,365.5,211.5,0.561,unknown,1449
351,35.100,0,471,187,508,275,37,88,489.5,231.0,0.838,unknown,3256
351,35.100,1,385,226,414,317,29,91,399.5,271.5,0.749,unknown,2639
351,35.100,2,696,225,726,315,30,90,711.0,270.0,0.744,unknown,2700
351,35.100,3,673,222,700,318,27,96,686.5,270.0,0.738,unknown,2592
356,35.600,0,498,189,540,280,42,91,519.0,234.5,0.823,unknown,3822
356,35.600,1,685,229,715,325,30,96,700.0,277.0,0.759,unknown,2880
356,35.600,2,714,230,745,324,31,94,729.5,277.0,0.749,unknown,2914
361,36.100,0,529,195,569,286,40,91,549.0,240.5,0.822,unknown,3640
361,36.100,1,698,235,736,335,38,100,717.0,285.0,0.818,unknown,3800
361,36.100,2,434,240,464,337,30,97,449.0,288.5,0.799,unknown,2910
361,36.100,3,732,238,765,332,33,94,748.5,285.0,0.723,unknown,3102
361,36.100,4,441,178,471,253,30,75,456.0,215.5,0.708,unknown,2250
361,36.100,5,368,176,404,247,36,71,386.0,211.5,0.701,unknown,2556
366,36.600,0,469,245,503,346,34,101,486.0,295.5,0.839,unknown,3434
366,36.600,1,561,197,600,289,39,92,580.5,243.0,0.815,unknown,3588
366,36.600,2,344,175,374,245,30,70,359.0,210.0,0.793,unknown,2100
366,36.600,3,716,248,753,349,37,101,734.5,298.5,0.781,unknown,3737
366,36.600,4,468,176,497,248,29,72,482.5,212.0,0.748,unknown,2088
371,37.100,0,733,258,767,357,34,99,750.0,307.5,0.822,unknown,3366
371,37.100,1,488,172,520,244,32,72,504.0,208.0,0.813,unknown,2304
371,37.100,2,499,254,536,353,37,99,517.5,303.5,0.812,unknown,3663
371,37.100,3,590,203,629,296,39,93,609.5,249.5,0.796,unknown,3627
371,37.100,4,321,172,355,245,34,73,338.0,208.5,0.615,unknown,2482
376,37.600,0,531,257,571,360,40,103,551.0,308.5,0.831,unknown,4120
376,37.600,1,619,207,660,304,41,97,639.5,255.5,0.830,unknown,3977
376,37.600,2,511,167,535,237,24,70,523.0,202.0,0.767,unknown,1680
376,37.600,3,306,174,335,249,29,75,320.5,211.5,0.751,unknown,2175
381,38.100,0,562,268,612,369,50,101,587.0,318.5,0.865,unknown,5050
381,38.100,1,535,162,565,231,30,69,550.0,196.5,0.783,unknown,2070
381,38.100,2,656,212,692,307,36,95,674.0,259.5,0.779,unknown,3420
381,38.100,3,277,177,311,254,34,77,294.0,215.5,0.751,unknown,2618
386,38.600,0,597,274,639,383,42,109,618.0,328.5,0.847,unknown,4578
386,38.600,1,681,214,724,314,43,100,702.5,264.0,0.821,unknown,4300
386,38.600,2,260,180,289,258,29,78,274.5,219.0,0.759,unknown,2262
386,38.600,3,554,154,581,224,27,70,567.5,189.0,0.749,unknown,1890
391,39.100,0,622,284,681,392,59,108,651.5,338.0,0.917,unknown,6372
391,39.100,1,571,150,596,215,25,65,583.5,182.5,0.811,unknown,1625
391,39.100,2,719,224,756,323,37,99,737.5,273.5,0.799,unknown,3663
391,39.100,3,254,188,288,266,34,78,271.0,227.0,0.794,unknown,2652
396,39.600,0,262,195,291,276,29,81,276.5,235.5,0.817,unknown,2349
396,39.600,1,585,144,613,207,28,63,599.0,175.5,0.806,unknown,1764
396,39.600,2,664,294,709,404,45,110,686.5,349.0,0.795,unknown,4950
401,40.100,0,686,300,744,410,58,110,715.0,355.0,0.862,unknown,6380
401,40.100,1,589,139,618,202,29,63,603.5,170.5,0.837,unknown,1827
401,40.100,2,273,201,301,282,28,81,287.0,241.5,0.784,unknown,2268
406,40.600,0,296,207,320,291,24,84,308.0,249.0,0.769,unknown,2016
406,40.600,1,571,136,602,198,31,62,586.5,167.0,0.664,unknown,1922
411,41.100,0,574,139,599,197,25,58,586.5,168.0,0.742,unknown,1450
411,41.100,1,298,203,319,291,21,88,308.5,247.0,0.708,unknown,1848
416,41.600,0,294,207,323,291,29,84,308.5,249.0,0.779,unknown,2436
416,41.600,1,562,141,589,204,27,63,575.5,172.5,0.774,unknown,1701
421,42.100,0,293,204,325,291,32,87,309.0,247.5,0.804,unknown,2784
421,42.100,1,552,145,575,207,23,62,563.5,176.0,0.778,unknown,1426
421,42.100,2,751,285,767,385,16,100,759.0,335.0,0.695,unknown,1600
426,42.600,0,708,277,758,379,50,102,733.0,328.0,0.819,unknown,5100
426,42.600,1,531,149,561,215,30,66,546.0,182.0,0.817,unknown,1980
426,42.600,2,298,204,320,291,22,87,309.0,247.5,0.750,unknown,1914
431,43.100,0,685,273,721,372,36,99,703.0,322.5,0.842,unknown,3564
431,43.100,1,522,156,551,222,29,66,536.5,189.0,0.827,unknown,1914
431,43.100,2,295,206,321,291,26,85,308.0,248.5,0.796,unknown,2210
436,43.600,0,651,264,692,363,41,99,671.5,313.5,0.838,unknown,4059
436,43.600,1,297,203,321,291,24,88,309.0,247.0,0.814,unknown,2112
436,43.600,2,511,161,537,230,26,69,524.0,195.5,0.804,unknown,1794
441,44.100,0,494,168,522,238,28,70,508.0,203.0,0.826,unknown,1960
441,44.100,1,615,255,647,353,32,98,631.0,304.0,0.812,unknown,3136
441,44.100,2,298,201,320,291,22,90,309.0,246.0,0.751,unknown,1980
446,44.600,0,582,249,617,346,35,97,599.5,297.5,0.828,unknown,3395
446,44.600,1,489,175,518,247,29,72,503.5,211.0,0.822,unknown,2088
446,44.600,2,298,202,327,289,29,87,312.5,245.5,0.756,unknown,2523
451,45.100,0,558,242,593,336,35,94,575.5,289.0,0.851,unknown,3290
451,45.100,1,310,206,336,289,26,83,323.0,247.5,0.830,unknown,2158
451,45.100,2,485,181,515,258,30,77,500.0,219.5,0.807,unknown,2310
456,45.600,0,493,193,522,272,29,79,507.5,232.5,0.861,unknown,2291
456,45.600,1,325,209,355,293,30,84,340.0,251.0,0.846,unknown,2520
456,45.600,2,538,236,570,327,32,91,554.0,281.5,0.836,unknown,2912
461,46.100,0,349,212,388,298,39,86,368.5,255.0,0.823,unknown,3354
461,46.100,1,510,230,547,317,37,87,528.5,273.5,0.778,unknown,3219
461,46.100,2,751,351,767,446,16,95,759.0,398.5,0.615,unknown,1520
461,46.100,3,508,203,539,249,31,46,523.5,226.0,0.510,unknown,1426
466,46.600,0,701,310,752,440,51,130,726.5,375.0,0.843,unknown,6630
466,46.600,1,522,216,556,297,34,81,539.0,256.5,0.823,unknown,2754
466,46.600,2,381,216,412,303,31,87,396.5,259.5,0.808,unknown,2697
466,46.600,3,484,219,511,306,27,87,497.5,262.5,0.803,unknown,2349
471,47.100,0,539,226,571,312,32,86,555.0,269.0,0.854,unknown,2752
471,47.100,1,671,296,714,423,43,127,692.5,359.5,0.846,unknown,5461
471,47.100,2,458,214,484,300,26,86,471.0,257.0,0.808,unknown,2236
471,47.100,3,404,238,444,310,40,72,424.0,274.0,0.603,unknown,2880
476,47.600,0,636,283,684,407,48,124,660.0,345.0,0.855,unknown,5952
476,47.600,1,557,235,591,323,34,88,574.0,279.0,0.853,unknown,2992
476,47.600,2,434,228,463,321,29,93,448.5,274.5,0.756,unknown,2697
481,48.100,0,463,237,509,337,46,100,486.0,287.0,0.869,unknown,4600
481,48.100,1,578,248,612,338,34,90,595.0,293.0,0.822,unknown,3060
481,48.100,2,608,270,643,385,35,115,625.5,327.5,0.818,unknown,4025
486,48.600,0,380,197,415,279,35,82,397.5,238.0,0.855,unknown,2870
486,48.600,1,584,258,624,374,40,116,604.0,316.0,0.809,unknown,4640
486,48.600,2,487,244,522,346,35,102,504.5,295.0,0.777,unknown,3570
486,48.600,3,608,257,633,367,25,110,620.5,312.0,0.529,unknown,2750
491,49.100,0,614,263,649,359,35,96,631.5,311.0,0.870,unknown,3360
491,49.100,1,570,250,606,361,36,111,588.0,305.5,0.865,unknown,3996
491,49.100,2,517,256,550,358,33,102,533.5,307.0,0.793,unknown,3366
491,49.100,3,359,194,386,272,27,78,372.5,233.0,0.777,unknown,2106
496,49.600,0,611,267,648,365,37,98,629.5,316.0,0.853,unknown,3626
496,49.600,1,536,266,575,372,39,106,555.5,319.0,0.798,unknown,4134
496,49.600,2,336,190,369,267,33,77,352.5,228.5,0.776,unknown,2541
496,49.600,3,567,244,596,357,29,113,581.5,300.5,0.730,unknown,3277
501,50.100,0,569,282,612,392,43,110,590.5,337.0,0.810,unknown,4730
501,50.100,1,305,189,331,263,26,74,318.0,226.0,0.799,unknown,1924
501,50.100,2,615,274,640,373,25,99,627.5,323.5,0.748,unknown,2475
501,50.100,3,555,238,593,345,38,107,574.0,291.5,0.623,unknown,4066
506,50.600,0,720,440,767,575,47,135,743.5,507.5,0.875,unknown,6345
506,50.600,1,553,229,589,336,36,107,571.0,282.5,0.829,unknown,3852
506,50.600,2,280,186,307,263,27,77,293.5,224.5,0.825,unknown,2079
506,50.600,3,735,236,767,331,32,95,751.0,283.5,0.758,unknown,3040
506,50.600,4,600,292,642,408,42,116,621.0,350.0,0.597,unknown,4872
511,51.100,0,646,436,717,576,71,140,681.5,506.0,0.857,unknown,9940
511,51.100,1,612,272,649,373,37,101,630.5,322.5,0.856,unknown,3737
511,51.100,2,536,223,567,323,31,100,551.5,273.0,0.848,unknown,3100
511,51.100,3,651,308,693,416,42,108,672.0,362.0,0.839,unknown,4536
511,51.100,4,256,183,287,258,31,75,271.5,220.5,0.779,unknown,2325
511,51.100,5,711,225,743,321,32,96,727.0,273.0,0.709,unknown,3072
516,51.600,0,610,273,649,371,39,98,629.5,322.0,0.854,unknown,3822
516,51.600,1,578,427,658,575,80,148,618.0,501.0,0.842,unknown,11840
516,51.600,2,689,316,739,434,50,118,714.0,375.0,0.841,unknown,5900
516,51.600,3,239,180,267,256,28,76,253.0,218.0,0.819,unknown,2128
516,51.600,4,512,214,544,315,32,101,528.0,264.5,0.799,unknown,3232
516,51.600,5,686,218,719,311,33,93,702.5,264.5,0.782,unknown,3069
521,52.100,0,497,425,555,575,58,150,526.0,500.0,0.851,unknown,8700
521,52.100,1,489,205,521,303,32,98,505.0,254.0,0.849,unknown,3136
521,52.100,2,223,177,253,249,30,72,238.0,213.0,0.806,unknown,2160
521,52.100,3,625,272,655,366,30,94,640.0,319.0,0.788,unknown,2820
521,52.100,4,663,209,693,301,30,92,678.0,255.0,0.747,unknown,2760
521,52.100,5,740,329,767,450,27,121,753.5,389.5,0.669,unknown,3267
526,52.600,0,636,203,670,288,34,85,653.0,245.5,0.816,unknown,2890
526,52.600,1,471,198,503,294,32,96,487.0,246.0,0.815,unknown,3072
526,52.600,2,207,176,233,247,26,71,220.0,211.5,0.801,unknown,1846
526,52.600,3,631,270,663,365,32,95,647.0,317.5,0.765,unknown,3040
526,52.600,4,428,421,481,570,53,149,454.5,495.5,0.758,unknown,7897
531,53.100,0,457,191,488,284,31,93,472.5,237.5,0.835,unknown,2883
531,53.100,1,188,174,221,243,33,69,204.5,208.5,0.830,unknown,2277
531,53.100,2,632,271,667,367,35,96,649.5,319.0,0.821,unknown,3360
531,53.100,3,622,194,656,280,34,86,639.0,237.0,0.814,unknown,2924
531,53.100,4,347,396,403,552,56,156,375.0,474.0,0.683,unknown,8736
536,53.600,0,633,277,671,378,38,101,652.0,327.5,0.877,unknown,3838
536,53.600,1,267,389,332,535,65,146,299.5,462.0,0.801,unknown,9490
536,53.600,2,612,186,651,271,39,85,631.5,228.5,0.800,unknown,3315
536,53.600,3,447,182,476,275,29,93,461.5,228.5,0.788,unknown,2697
536,53.600,4,323,381,367,519,44,138,345.0,450.0,0.788,unknown,6072
536,53.600,5,165,171,198,239,33,68,181.5,205.0,0.781,unknown,2244
541,54.100,0,280,377,336,512,56,135,308.0,444.5,0.867,unknown,7560
541,54.100,1,608,179,642,260,34,81,625.0,219.5,0.839,unknown,2754
541,54.100,2,639,286,679,388,40,102,659.0,337.0,0.834,unknown,4080
541,54.100,3,436,177,466,267,30,90,451.0,222.0,0.800,unknown,2700
541,54.100,4,235,382,282,526,47,144,258.5,454.0,0.785,unknown,6768
541,54.100,5,158,169,187,236,29,67,172.5,202.5,0.776,unknown,1943
546,54.600,0,185,375,262,521,77,146,223.5,448.0,0.910,unknown,11242
546,54.600,1,631,294,673,401,42,107,652.0,347.5,0.870,unknown,4494
546,54.600,2,258,370,311,510,53,140,284.5,440.0,0.863,unknown,7420
546,54.600,3,144,165,172,234,28,69,158.0,199.5,0.809,unknown,1932
546,54.600,4,598,171,633,253,35,82,615.5,212.0,0.800,unknown,2870
551,55.100,0,168,367,225,512,57,145,196.5,439.5,0.896,unknown,8265
551,55.100,1,234,374,288,510,54,136,261.0,442.0,0.873,unknown,7344
551,55.100,2,595,167,630,243,35,76,612.5,205.0,0.828,unknown,2660
551,55.100,3,641,302,671,411,30,109,656.0,356.5,0.804,unknown,3270
551,55.100,4,124,167,156,231,32,64,140.0,199.0,0.762,unknown,2048
556,55.600,0,167,357,216,501,49,144,191.5,429.0,0.886,unknown,7056
556,55.600,1,214,382,267,525,53,143,240.5,453.5,0.855,unknown,7579
556,55.600,2,105,167,135,232,30,65,120.0,199.5,0.830,unknown,1950
556,55.600,3,642,304,671,410,29,106,656.5,357.0,0.813,unknown,3074
556,55.600,4,586,159,618,236,32,77,602.0,197.5,0.775,unknown,2464
556,55.600,5,398,158,423,239,25,81,410.5,198.5,0.629,unknown,2025
561,56.100,0,641,304,671,410,30,106,656.0,357.0,0.816,unknown,3180
561,56.100,1,194,392,246,536,52,144,220.0,464.0,0.785,unknown,7488
561,56.100,2,380,157,407,235,27,78,393.5,196.0,0.769,unknown,2106
561,56.100,3,172,353,208,491,36,138,190.0,422.0,0.741,unknown,4968
561,56.100,4,82,171,112,238,30,67,97.0,204.5,0.722,unknown,2010
561,56.100,5,583,157,614,234,31,77,598.5,195.5,0.699,unknown,2387
566,56.600,0,641,304,671,410,30,106,656.0,357.0,0.813,unknown,3180
566,56.600,1,55,172,79,238,24,66,67.0,205.0,0.768,unknown,1584
566,56.600,2,360,150,387,228,27,78,373.5,189.0,0.754,unknown,2106
566,56.600,3,587,158,609,234,22,76,598.0,196.0,0.741,unknown,1672
566,56.600,4,180,349,263,553,83,204,221.5,451.0,0.599,unknown,16932
571,57.100,0,171,410,233,562,62,152,202.0,486.0,0.848,unknown,9424
571,57.100,1,569,160,598,237,29,77,583.5,198.5,0.836,unknown,2233
571,57.100,2,641,304,671,411,30,107,656.0,357.5,0.807,unknown,3210
571,57.100,3,340,147,367,225,27,78,353.5,186.0,0.799,unknown,2106
571,57.100,4,27,175,47,243,20,68,37.0,209.0,0.778,unknown,1360
571,57.100,5,189,345,235,482,46,137,212.0,413.5,0.751,unknown,6302
571,57.100,6,742,244,767,345,25,101,754.5,294.5,0.706,unknown,2525
576,57.600,0,159,417,222,573,63,156,190.5,495.0,0.891,unknown,9828
576,57.600,1,625,304,670,411,45,107,647.5,357.5,0.853,unknown,4815
576,57.600,2,196,341,243,476,47,135,219.5,408.5,0.847,unknown,6345
576,57.600,3,312,145,350,220,38,75,331.0,182.5,0.829,unknown,2850
576,57.600,4,569,166,599,241,30,75,584.0,203.5,0.769,unknown,2250
576,57.600,5,2,178,24,243,22,65,13.0,210.5,0.730,unknown,1430
576,57.600,6,717,238,749,335,32,97,733.0,286.5,0.715,unknown,3104
581,58.100,0,186,430,255,575,69,145,220.5,502.5,0.882,unknown,10005
581,58.100,1,230,336,278,469,48,133,254.0,402.5,0.857,unknown,6384
581,58.100,2,674,230,716,327,42,97,695.0,278.5,0.800,unknown,4074
581,58.100,3,639,304,668,411,29,107,653.5,357.5,0.789,unknown,3103
581,58.100,4,285,146,321,218,36,72,303.0,182.0,0.779,unknown,2592
581,58.100,5,580,171,615,250,35,79,597.5,210.5,0.750,unknown,2765
586,58.600,0,226,423,292,576,66,153,259.0,499.5,0.885,unknown,10098
586,58.600,1,272,327,328,449,56,122,300.0,388.0,0.873,unknown,6832
586,58.600,2,599,177,638,259,39,82,618.5,218.0,0.821,unknown,3198
586,58.600,3,639,304,669,411,30,107,654.0,357.5,0.766,unknown,3210
586,58.600,4,648,224,684,321,36,97,666.0,272.5,0.743,unknown,3492
586,58.600,5,258,146,292,216,34,70,275.0,181.0,0.730,unknown,2380
586,58.600,6,261,145,284,217,23,72,272.5,181.0,0.539,unknown,1656
591,59.100,0,259,433,326,575,67,142,292.5,504.0,0.889,unknown,9514
591,59.100,1,345,314,382,437,37,123,363.5,375.5,0.820,unknown,4551
591,59.100,2,635,305,672,412,37,107,653.5,358.5,0.797,unknown,3959
591,59.100,3,232,144,263,215,31,71,247.5,179.5,0.745,unknown,2201
591,59.100,4,620,225,658,306,38,81,639.0,265.5,0.699,unknown,3078
596,59.600,0,260,433,309,574,49,141,284.5,503.5,0.874,unknown,6909
596,59.600,1,389,312,442,431,53,119,415.5,371.5,0.847,unknown,6307
596,59.600,2,595,207,629,298,34,91,612.0,252.5,0.821,unknown,3094
596,59.600,3,641,304,674,411,33,107,657.5,357.5,0.813,unknown,3531
596,59.600,4,208,146,242,216,34,70,225.0,181.0,0.763,unknown,2380
596,59.600,5,643,198,679,286,36,88,661.0,242.0,0.761,unknown,3168
601,60.100,0,282,432,331,575,49,143,306.5,503.5,0.848,unknown,7007
601,60.100,1,454,302,505,420,51,118,479.5,361.0,0.836,unknown,6018
601,60.100,2,641,304,671,411,30,107,656.0,357.5,0.801,unknown,3210
601,60.100,3,568,198,596,287,28,89,582.0,242.5,0.787,unknown,2492
601,60.100,4,188,144,216,214,28,70,202.0,179.0,0.709,unknown,1960
601,60.100,5,670,207,705,296,35,89,687.5,251.5,0.640,unknown,3115
606,60.600,0,311,428,372,575,61,147,341.5,501.5,0.863,unknown,8967
606,60.600,1,494,296,541,412,47,116,517.5,354.0,0.854,unknown,5452
606,60.600,2,530,194,566,279,36,85,548.0,236.5,0.842,unknown,3060
606,60.600,3,694,221,732,313,38,92,713.0,267.0,0.775,unknown,3496
606,60.600,4,638,304,669,411,31,107,653.5,357.5,0.774,unknown,3317
606,60.600,5,162,142,192,211,30,69,177.0,176.5,0.739,unknown,2070
606,60.600,6,0,191,20,253,20,62,10.0,222.0,0.692,unknown,1240
611,61.100,0,345,427,399,575,54,148,372.0,501.0,0.886,unknown,7992
611,61.100,1,717,229,759,326,42,97,738.0,277.5,0.827,unknown,4074
611,61.100,2,528,293,581,402,53,109,554.5,347.5,0.825,unknown,5777
611,61.100,3,8,183,44,251,36,68,26.0,217.0,0.814,unknown,2448
611,61.100,4,507,189,541,273,34,84,524.0,231.0,0.802,unknown,2856
611,61.100,5,640,304,670,411,30,107,655.0,357.5,0.774,unknown,3210
611,61.100,6,148,140,169,211,21,71,158.5,175.5,0.766,unknown,1491
616,61.600,0,369,424,418,574,49,150,393.5,499.0,0.859,unknown,7350
616,61.600,1,570,274,606,384,36,110,588.0,329.0,0.839,unknown,3960
616,61.600,2,479,178,517,263,38,85,498.0,220.5,0.835,unknown,3230
616,61.600,3,637,305,671,411,34,106,654.0,358.0,0.826,unknown,3604
616,61.600,4,34,181,73,249,39,68,53.5,215.0,0.791,unknown,2652
616,61.600,5,131,139,158,209,27,70,144.5,174.0,0.742,unknown,1890
616,61.600,6,740,244,767,332,27,88,753.5,288.0,0.668,unknown,2376
621,62.100,0,373,422,430,574,57,152,401.5,498.0,0.887,unknown,8664
621,62.100,1,578,261,618,365,40,104,598.0,313.0,0.871,unknown,4160
621,62.100,2,610,295,655,398,45,103,632.5,346.5,0.830,unknown,4635
621,62.100,3,457,173,493,253,36,80,475.0,213.0,0.807,unknown,2880
621,62.100,4,64,178,99,246,35,68,81.5,212.0,0.748,unknown,2380
621,62.100,5,121,141,146,208,25,67,133.5,174.5,0.745,unknown,1675
626,62.600,0,358,408,412,558,54,150,385.0,483.0,0.878,unknown,8100
626,62.600,1,97,174,122,241,25,67,109.5,207.5,0.750,unknown,1675
626,62.600,2,586,285,632,382,46,97,609.0,333.5,0.734,unknown,4462
626,62.600,3,115,139,134,207,19,68,124.5,173.0,0.730,unknown,1292
626,62.600,4,437,166,462,244,25,78,449.5,205.0,0.712,unknown,1950
626,62.600,5,593,246,635,340,42,94,614.0,293.0,0.620,unknown,3948
631,63.100,0,351,395,406,542,55,147,378.5,468.5,0.870,unknown,8085
631,63.100,1,620,234,658,332,38,98,639.0,283.0,0.864,unknown,3724
631,63.100,2,556,267,593,362,37,95,574.5,314.5,0.859,unknown,3515
636,63.600,0,633,226,670,320,37,94,651.5,273.0,0.863,unknown,3478
636,63.600,1,337,390,393,534,56,144,365.0,462.0,0.861,unknown,8064
636,63.600,2,537,257,570,350,33,93,553.5,303.5,0.812,unknown,3069
636,63.600,3,142,165,170,233,28,68,156.0,199.0,0.775,unknown,1904
636,63.600,4,114,140,134,208,20,68,124.0,174.0,0.741,unknown,1360
636,63.600,5,395,159,419,234,24,75,407.0,196.5,0.699,unknown,1800
641,64.100,0,334,384,387,525,53,141,360.5,454.5,0.850,unknown,7473
641,64.100,1,644,209,679,304,35,95,661.5,256.5,0.828,unknown,3325
641,64.100,2,505,247,537,337,32,90,521.0,292.0,0.794,unknown,2880
641,64.100,3,117,142,140,213,23,71,128.5,177.5,0.784,unknown,1633
641,64.100,4,363,159,395,230,32,71,379.0,194.5,0.770,unknown,2272
641,64.100,5,171,160,195,229,24,69,183.0,194.5,0.748,unknown,1656
646,64.600,0,340,382,390,516,50,134,365.0,449.0,0.874,unknown,6700
646,64.600,1,640,203,678,295,38,92,659.0,249.0,0.861,unknown,3496
646,64.600,2,482,238,518,325,36,87,500.0,281.5,0.813,unknown,3132
646,64.600,3,126,147,151,216,25,69,138.5,181.5,0.796,unknown,1725
646,64.600,4,342,156,374,229,32,73,358.0,192.5,0.744,unknown,2336
646,64.600,5,194,159,216,225,22,66,205.0,192.0,0.718,unknown,1452
651,65.100,0,332,372,383,515,51,143,357.5,443.5,0.872,unknown,7293
651,65.100,1,468,225,500,313,32,88,484.0,269.0,0.820,unknown,2816
651,65.100,2,308,157,349,228,41,71,328.5,192.5,0.804,unknown,2911
651,65.100,3,139,148,164,221,25,73,151.5,184.5,0.785,unknown,1825
651,65.100,4,640,193,670,275,30,82,655.0,234.0,0.782,unknown,2460
651,65.100,5,221,156,240,223,19,67,230.5,189.5,0.706,unknown,1273
656,65.600,0,324,364,371,500,47,136,347.5,432.0,0.862,unknown,6392
656,65.600,1,627,184,660,269,33,85,643.5,226.5,0.833,unknown,2805
656,65.600,2,459,214,492,295,33,81,475.5,254.5,0.808,unknown,2673
656,65.600,3,733,309,767,422,34,113,750.0,365.5,0.780,unknown,3842
656,65.600,4,247,154,267,219,20,65,257.0,186.5,0.767,unknown,1300
656,65.600,5,289,157,323,229,34,72,306.0,193.0,0.762,unknown,2448
656,65.600,6,156,149,184,222,28,73,170.0,185.5,0.751,unknown,2044
661,66.100,0,295,356,358,490,63,134,326.5,423.0,0.906,unknown,8442
661,66.100,1,460,204,492,282,32,78,476.0,243.0,0.855,unknown,2496
661,66.100,2,684,293,726,411,42,118,705.0,352.0,0.845,unknown,4956
661,66.100,3,176,150,210,222,34,72,193.0,186.0,0.821,unknown,2448
661,66.100,4,618,176,646,257,28,81,632.0,216.5,0.734,unknown,2268
661,66.100,5,267,153,301,227,34,74,284.0,190.0,0.687,unknown,2516
666,66.600,0,265,347,312,478,47,131,288.5,412.5,0.857,unknown,6157
666,66.600,1,612,278,658,393,46,115,635.0,335.5,0.841,unknown,5290
666,66.600,2,461,194,491,271,30,77,476.0,232.5,0.809,unknown,2310
666,66.600,3,304,151,334,217,30,66,319.0,184.0,0.769,unknown,1980
666,66.600,4,250,155,278,226,28,71,264.0,190.5,0.759,unknown,1988
666,66.600,5,596,167,622,245,26,78,609.0,206.0,0.749,unknown,2028
666,66.600,6,200,153,225,227,25,74,212.5,190.0,0.739,unknown,1850
671,67.100,0,223,345,285,469,62,124,254.0,407.0,0.894,unknown,7688
671,67.100,1,565,264,598,370,33,106,581.5,317.0,0.841,unknown,3498
671,67.100,2,468,184,497,261,29,77,482.5,222.5,0.803,unknown,2233
671,67.100,3,574,164,600,237,26,73,587.0,200.5,0.771,unknown,1898
671,67.100,4,220,154,253,229,33,75,236.5,191.5,0.730,unknown,2475
671,67.100,5,324,150,354,216,30,66,339.0,183.0,0.674,unknown,1980
676,67.600,0,195,337,242,462,47,125,218.5,399.5,0.878,unknown,5875
676,67.600,1,497,255,552,358,55,103,524.5,306.5,0.855,unknown,5665
676,67.600,2,474,178,502,251,28,73,488.0,214.5,0.788,unknown,2044
676,67.600,3,240,159,270,234,30,75,255.0,196.5,0.769,unknown,2250
676,67.600,4,350,149,382,216,32,67,366.0,182.5,0.763,unknown,2144
676,67.600,5,199,154,230,222,31,68,214.5,188.0,0.739,unknown,2108
676,67.600,6,551,157,573,233,22,76,562.0,195.0,0.705,unknown,1672
681,68.100,0,151,330,200,450,49,120,175.5,390.0,0.861,unknown,5880
681,68.100,1,448,242,480,342,32,100,464.0,292.0,0.792,unknown,3200
681,68.100,2,516,156,539,229,23,73,527.5,192.5,0.777,unknown,1679
681,68.100,3,487,168,513,240,26,72,500.0,204.0,0.773,unknown,1872
681,68.100,4,273,158,304,237,31,79,288.5,197.5,0.742,unknown,2449
681,68.100,5,169,156,204,223,35,67,186.5,189.5,0.727,unknown,2345
681,68.100,6,387,148,405,214,18,66,396.0,181.0,0.639,unknown,1188
686,68.600,0,125,318,173,440,48,122,149.0,379.0,0.875,unknown,5856
686,68.600,1,504,164,530,234,26,70,517.0,199.0,0.789,unknown,1820
686,68.600,2,300,160,323,240,23,80,311.5,200.0,0.770,unknown,1840
686,68.600,3,402,237,434,328,32,91,418.0,282.5,0.754,unknown,2912
686,68.600,4,154,158,182,226,28,68,168.0,192.0,0.708,unknown,1904
686,68.600,5,487,154,507,225,20,71,497.0,189.5,0.671,unknown,1420
691,69.100,0,120,307,163,426,43,119,141.5,366.5,0.863,unknown,5117
691,69.100,1,349,225,385,317,36,92,367.0,271.0,0.855,unknown,3312
691,69.100,2,153,161,180,232,27,71,166.5,196.5,0.764,unknown,1917
691,69.100,3,523,158,551,228,28,70,537.0,193.0,0.764,unknown,1960
691,69.100,4,327,163,359,246,32,83,343.0,204.5,0.712,unknown,2656
691,69.100,5,746,226,767,317,21,91,756.5,271.5,0.708,unknown,1911
691,69.100,6,446,152,473,223,27,71,459.5,187.5,0.693,unknown,1917
696,69.600,0,110,297,153,409,43,112,131.5,353.0,0.873,unknown,4816
696,69.600,1,719,222,760,313,41,91,739.5,267.5,0.817,unknown,3731
696,69.600,2,315,219,356,306,41,87,335.5,262.5,0.789,unknown,3567
696,69.600,3,163,165,193,237,30,72,178.0,201.0,0.779,unknown,2160
696,69.600,4,529,159,555,227,26,68,542.0,193.0,0.770,unknown,1768
696,69.600,5,346,168,369,249,23,81,357.5,208.5,0.725,unknown,1863
696,69.600,6,456,139,475,203,19,64,465.5,171.0,0.687,unknown,1216
701,70.100,0,102,286,142,396,40,110,122.0,341.0,0.828,unknown,4400
701,70.100,1,682,218,729,306,47,88,705.5,262.0,0.809,unknown,4136
701,70.100,2,519,166,544,234,25,68,531.5,200.0,0.784,unknown,1700
701,70.100,3,474,136,495,201,21,65,484.5,168.5,0.767,unknown,1365
701,70.100,4,280,210,308,294,28,84,294.0,252.0,0.764,unknown,2352
701,70.100,5,184,166,210,237,26,71,197.0,201.5,0.764,unknown,1846
701,70.100,6,365,169,397,254,32,85,381.0,211.5,0.742,unknown,2720
701,70.100,7,403,150,424,206,21,56,413.5,178.0,0.621,unknown,1176
706,70.600,0,84,275,128,381,44,106,106.0,328.0,0.877,unknown,4664
706,70.600,1,650,209,679,301,29,92,664.5,255.0,0.805,unknown,2668
706,70.600,2,208,169,231,243,23,74,219.5,206.0,0.772,unknown,1702
706,70.600,3,236,201,266,282,30,81,251.0,241.5,0.770,unknown,2430
706,70.600,4,505,173,533,245,28,72,519.0,209.0,0.718,unknown,2016
706,70.600,5,389,179,423,262,34,83,406.0,220.5,0.660,unknown,2822
706,70.600,6,495,131,516,196,21,65,505.5,163.5,0.649,unknown,1365
706,70.600,7,376,152,396,225,20,73,386.0,188.5,0.589,unknown,1460
711,71.100,0,513,129,538,192,25,63,525.5,160.5,0.814,unknown,1575
711,71.100,1,494,177,520,253,26,76,507.0,215.0,0.811,unknown,1976
711,71.100,2,62,266,108,367,46,101,85.0,316.5,0.789,unknown,4646
711,71.100,3,617,208,653,296,36,88,635.0,252.0,0.775,unknown,3168
711,71.100,4,223,174,258,250,35,76,240.5,212.0,0.774,unknown,2660
711,71.100,5,202,195,232,273,30,78,217.0,234.0,0.747,unknown,2340
711,71.100,6,349,157,370,228,21,71,359.5,192.5,0.687,unknown,1491
716,71.600,0,55,256,92,353,37,97,73.5,304.5,0.838,unknown,3589
716,71.600,1,588,203,614,291,26,88,601.0,247.0,0.795,unknown,2288
716,71.600,2,437,189,472,281,35,92,454.5,235.0,0.767,unknown,3220
716,71.600,3,480,183,508,261,28,78,494.0,222.0,0.762,unknown,2184
716,71.600,4,534,127,565,189,31,62,549.5,158.0,0.761,unknown,1922
716,71.600,5,244,177,274,257,30,80,259.0,217.0,0.758,unknown,2400
716,71.600,6,316,160,347,233,31,73,331.5,196.5,0.722,unknown,2263
716,71.600,7,163,187,191,259,28,72,177.0,223.0,0.696,unknown,2016
721,72.100,0,59,248,95,339,36,91,77.0,293.5,0.838,unknown,3276
721,72.100,1,299,167,330,242,31,75,314.5,204.5,0.803,unknown,2325
721,72.100,2,460,198,494,293,34,95,477.0,245.5,0.793,unknown,3230
721,72.100,3,562,199,591,287,29,88,576.5,243.0,0.781,unknown,2552
721,72.100,4,261,183,290,260,29,77,275.5,221.5,0.765,unknown,2233
721,72.100,5,130,184,165,257,35,73,147.5,220.5,0.726,unknown,2555
721,72.100,6,496,187,520,264,24,77,508.0,225.5,0.687,unknown,1848
721,72.100,7,556,126,583,185,27,59,569.5,155.5,0.671,unknown,1593
726,72.600,0,79,239,114,328,35,89,96.5,283.5,0.825,unknown,3115
726,72.600,1,487,204,522,302,35,98,504.5,253.0,0.766,unknown,3430
726,72.600,2,96,177,122,249,26,72,109.0,213.0,0.757,unknown,1872
726,72.600,3,528,192,562,281,34,89,545.0,236.5,0.745,unknown,3026
726,72.600,4,574,122,602,182,28,60,588.0,152.0,0.706,unknown,1680
726,72.600,5,286,174,314,268,28,94,300.0,221.0,0.650,unknown,2632
731,73.100,0,496,195,531,277,35,82,513.5,236.0,0.761,unknown,2870
731,73.100,1,93,229,129,315,36,86,111.0,272.0,0.747,unknown,3096
731,73.100,2,278,180,308,259,30,79,293.0,219.5,0.738,unknown,2370
731,73.100,3,590,118,615,178,25,60,602.5,148.0,0.732,unknown,1500
731,73.100,4,65,175,94,243,29,68,79.5,209.0,0.709,unknown,1972
731,73.100,5,306,192,333,275,27,83,319.5,233.5,0.700,unknown,2241
731,73.100,6,556,189,586,266,30,77,571.0,227.5,0.643,unknown,2310
731,73.100,7,515,210,550,306,35,96,532.5,258.0,0.547,unknown,3360
736,73.600,0,568,187,597,263,29,76,582.5,225.0,0.812,unknown,2204
736,73.600,1,42,172,68,240,26,68,55.0,206.0,0.785,unknown,1768
736,73.600,2,537,213,581,311,44,98,559.0,262.0,0.776,unknown,4312
736,73.600,3,474,188,501,272,27,84,487.5,230.0,0.771,unknown,2268
736,73.600,4,109,224,143,307,34,83,126.0,265.5,0.759,unknown,2822
736,73.600,5,321,195,357,279,36,84,339.0,237.0,0.750,unknown,3024
736,73.600,6,272,186,307,268,35,82,289.5,227.0,0.703,unknown,2870
736,73.600,7,597,115,631,175,34,60,614.0,145.0,0.652,unknown,2040
741,74.100,0,566,218,611,318,45,100,588.5,268.0,0.823,unknown,4500
741,74.100,1,339,201,371,288,32,87,355.0,244.5,0.797,unknown,2784
741,74.100,2,266,197,299,278,33,81,282.5,237.5,0.745,unknown,2673
741,74.100,3,556,183,583,256,27,73,569.5,219.5,0.738,unknown,1971
741,74.100,4,442,186,468,268,26,82,455.0,227.0,0.732,unknown,2132
741,74.100,5,622,116,648,173,26,57,635.0,144.5,0.725,unknown,1482
741,74.100,6,127,216,157,298,30,82,142.0,257.0,0.719,unknown,2460
741,74.100,7,15,169,45,234,30,65,30.0,201.5,0.716,unknown,1950
746,74.600,0,600,218,650,319,50,101,625.0,268.5,0.867,unknown,5050
746,74.600,1,246,208,284,292,38,84,265.0,250.0,0.845,unknown,3192
746,74.600,2,370,207,402,297,32,90,386.0,252.0,0.770,unknown,2880
746,74.600,3,156,210,191,289,35,79,173.5,249.5,0.754,unknown,2765
746,74.600,4,529,179,559,250,30,71,544.0,214.5,0.732,unknown,2130
746,74.600,5,641,114,671,172,30,58,656.0,143.0,0.689,unknown,1740
746,74.600,6,0,169,8,230,8,61,4.0,199.5,0.583,unknown,488
751,75.100,0,634,216,677,318,43,102,655.5,267.0,0.837,unknown,4386
751,75.100,1,236,214,274,302,38,88,255.0,258.0,0.827,unknown,3344
751,75.100,2,508,175,534,248,26,73,521.0,211.5,0.788,unknown,1898
751,75.100,3,660,116,689,174,29,58,674.5,145.0,0.780,unknown,1682
751,75.100,4,397,211,423,299,26,88,410.0,255.0,0.755,unknown,2288
751,75.100,5,179,202,220,279,41,77,199.5,240.5,0.742,unknown,3157
751,75.100,6,369,180,401,257,32,77,385.0,218.5,0.661,unknown,2464
756,75.600,0,654,209,689,314,35,105,671.5,261.5,0.842,unknown,3675
756,75.600,1,336,180,375,255,39,75,355.5,217.5,0.813,unknown,2925
756,75.600,2,232,225,270,314,38,89,251.0,269.5,0.811,unknown,3382
756,75.600,3,481,176,514,245,33,69,497.5,210.5,0.709,unknown,2277
756,75.600,4,212,196,240,275,28,79,226.0,235.5,0.674,unknown,2212
756,75.600,5,425,228,465,309,40,81,445.0,268.5,0.672,unknown,3240
756,75.600,6,677,120,698,179,21,59,687.5,149.5,0.638,unknown,1239
761,76.100,0,650,205,681,302,31,97,665.5,253.5,0.806,unknown,3007
761,76.100,1,237,233,279,328,42,95,258.0,280.5,0.800,unknown,3990
761,76.100,2,312,177,344,252,32,75,328.0,214.5,0.780,unknown,2400
761,76.100,3,453,222,490,314,37,92,471.5,268.0,0.751,unknown,3404
761,76.100,4,682,123,705,182,23,59,693.5,152.5,0.705,unknown,1357
761,76.100,5,230,192,256,269,26,77,243.0,230.5,0.622,unknown,2002
761,76.100,6,231,192,257,249,26,57,244.0,220.5,0.502,unknown,1482
766,76.600,0,256,239,301,334,45,95,278.5,286.5,0.857,unknown,4275
766,76.600,1,634,199,667,295,33,96,650.5,247.0,0.763,unknown,3168
766,76.600,2,477,227,512,322,35,95,494.5,274.5,0.760,unknown,3325
766,76.600,3,287,176,312,252,25,76,299.5,214.0,0.749,unknown,1900
766,76.600,4,686,125,710,187,24,62,698.0,156.0,0.710,unknown,1488
766,76.600,5,252,188,277,262,25,74,264.5,225.0,0.692,unknown,1850
771,77.100,0,287,244,331,342,44,98,309.0,293.0,0.839,unknown,4312
771,77.100,1,504,232,540,326,36,94,522.0,279.0,0.778,unknown,3384
771,77.100,2,619,196,647,290,28,94,633.0,243.0,0.772,unknown,2632
771,77.100,3,397,190,418,264,21,74,407.5,227.0,0.657,unknown,1554
771,77.100,4,680,129,705,190,25,61,692.5,159.5,0.639,unknown,1525
771,77.100,5,266,172,300,255,34,83,283.0,213.5,0.604,unknown,2822
776,77.600,0,544,240,574,338,30,98,559.0,289.0,0.808,unknown,2940
776,77.600,1,352,197,384,268,32,71,368.0,232.5,0.793,unknown,2272
776,77.600,2,324,250,362,352,38,102,343.0,301.0,0.788,unknown,3876
776,77.600,3,608,195,637,290,29,95,622.5,242.5,0.781,unknown,2755
776,77.600,4,673,133,700,198,27,65,686.5,165.5,0.719,unknown,1755
776,77.600,5,251,168,275,243,24,75,263.0,205.5,0.716,unknown,1800
776,77.600,6,294,177,325,251,31,74,309.5,214.0,0.677,unknown,2294
781,78.100,0,611,201,644,297,33,96,627.5,249.0,0.830,unknown,3168
781,78.100,1,349,260,393,365,44,105,371.0,312.5,0.828,unknown,4620
781,78.100,2,566,246,604,349,38,103,585.0,297.5,0.823,unknown,3914
781,78.100,3,237,166,262,243,25,77,249.5,204.5,0.769,unknown,1925
781,78.100,4,664,136,689,202,25,66,676.5,169.0,0.721,unknown,1650
781,78.100,5,309,200,347,275,38,75,328.0,237.5,0.608,unknown,2850
786,78.600,0,582,256,630,361,48,105,606.0,308.5,0.836,unknown,5040
786,78.600,1,389,265,425,369,36,104,407.0,317.0,0.831,unknown,3744
786,78.600,2,618,213,652,311,34,98,635.0,262.0,0.800,unknown,3332
786,78.600,3,270,196,295,272,25,76,282.5,234.0,0.767,unknown,1900
786,78.600,4,224,164,252,238,28,74,238.0,201.0,0.766,unknown,2072
786,78.600,5,342,173,378,240,36,67,360.0,206.5,0.696,unknown,2412
786,78.600,6,654,140,680,205,26,65,667.0,172.5,0.677,unknown,1690
791,79.100,0,600,263,643,373,43,110,621.5,318.0,0.867,unknown,4730
791,79.100,1,632,223,670,325,38,102,651.0,274.0,0.813,unknown,3876
791,79.100,2,652,143,675,213,23,70,663.5,178.0,0.798,unknown,1610
791,79.100,3,223,159,249,229,26,70,236.0,194.0,0.774,unknown,1820
791,79.100,4,246,193,275,267,29,74,260.5,230.0,0.743,unknown,2146
791,79.100,5,367,165,401,237,34,72,384.0,201.0,0.703,unknown,2448
791,79.100,6,419,270,450,391,31,121,434.5,330.5,0.507,unknown,3751
